65backup	65backup
Administrator	
Audit	审计中心
baiyunfei	白云飞
basj	巴淑娟
bixm	BI项目
changli	苌莉
chenlei	陈雷
chenzz	陈镇洲
cwgs	财务公司
dahua	大华
dan.zhao	赵丹
dshbgs	董事会办公室
fan.yang	杨帆
fangfeng	方峰
fsrpa01	fsrpa01
fwb	法务部
gongqy	龚庆宇
Guest	
gyyjy	工业研究院
hanchao	韩超
heyanbiao	何雁飚
hlijun	黄丽君
huangjun1	黄俊
huanglj	通力-人力资源部
huangning2	黄宁
huikai.zhuang	庄汇凯
itsrv.sz01	itsrv.sz01
IUSR_CW-SHAREFILES	Internet 来宾帐户
jiabin.he	何嘉斌
jiangxs	蒋先松
jianqin	jianqin
jingcm	净春梅
kuangyao	况瑶
laiyi	赖翼
lancai	蓝才
lhp	lhp
li.zhao	赵立
liaobh	廖笔华
liaoml	廖敏玲
lingyan2.dong	董玲燕
liugh	刘国辉
liujiaqi	刘佳琪
liuw01	刘伟
lu2.peng	彭璐
lucl	卢翠玲
luojinxi	罗金喜
lur.yin	尹璐儿
lvrui	吕睿
lwfeng	刘卫峰
pengyan	彭燕
ppglzx	品牌管理中心
qing10.wu	吴晴
ran2.wang	王冉
raojun	饶君
robot	合并报表财务机器人专用
robot1	合并报表财务机器人专用
robot2	合并报表财务机器人专用
robot3	合并报表财务机器人专用
saadmin	saadmin
sdbg	SDBG专用
shaotian	吴少添
shenpp	沈萍萍
shizm	史争鸣
syzy	实业专用
test	test
test01	test01
tjing	唐婧
txl	唐小蕾
weiling.zeng	曾伟灵
wind	万德
wjd	王久斗
wwg	wwg
xiaofp	肖丰萍
xiaona.geng	耿晓娜
xiaotong.ye	叶晓彤
xin10.zhao	赵昕
xinghua1.liu	刘星华
xingjunyu	邢俊瑜
xingrong	邢蓉
xiongmm	熊苗苗
xujing	徐晶
xuluoluo	徐荦荦
xupeng	徐鹏
xxbin	许栩彬
yangdc	杨定聪
yangxin03	杨欣
yaozifan	姚子凡
yeshuyu	叶淑裕
yihao1.tang	唐毅豪
yuanyd	袁艺丹
yxqing	袁晓青
zcb	总裁办
zenghuiru	曾慧如
zengjianhong	曾健宏
zengyong	曾勇
zhangmq	张梦琪
zhangqd	张其东
zhaolin	赵林
zhizhan.liao	廖志展
zhonghuan	中环公用账号
zhouhq	周荟全
zhuanghuansheng	zhuanghuansheng@tcl.com
zhuweiwen	集团HR-朱卫文
zhyuanyuan	张媛媛
zltzb	战略投资部
zpying	张培颖
zzb	组织部
